111111111
100000001
101001001
100000001
111111111
