NO ./path_to_the_north_texture
SO ./path_to_the_south_texture
EA ./path_to_the_east_texture
C 255,0,0

WE ./path_to_the_west_texture
F 123,255,255


     11111111 1111111 1111111111 1
     11111111111111111111111101111
     10000000000000110000000000011111111111111111111
     10001100000111000000000000111111111
     111001000000000000000000001
11111111011000001110000000000001
100000000011000001110111111111111
1111011111111101110000E010001                                                                                      1
111101111111110111010100100001
11000000110101011100000010001
10000000000000001100000010001                                 111
100000000000000011010100100011111111                          101
1100000110000000101010101110001111111                         111
1111111111111111111111111111111111111111
11110111 1110101 1011010100011111111111
11111111 1111111 11110111111 111
11111111 1111111 111000001111 111
11111111 1111111 1111111111 1 111




1111111111111111111111111
1000000000110000000000001
1011000001110000000000001
1001000000000000000000001
1111111111111111111111111

