NO ./path_to_the_north_texture
SO ./path_to_the_south_texture
WE ./path_to_the_west_texture
EA ./path_to_the_east_texture

F 255,255,255
C 2,0,0

1111 1111111 1111111111 1
11111111111111111111111 1
1000000000000000110101001                           101
1100000110000000101010101111                        101
1000000000000000110000001111111                     111
1000000000110000000000001
1011000001110000000000001
100100000000000000000N001
1111111111111111111111111
11  1111111111  111111  1
11  1111111111  111111  1
11  11111 1111  111111  1